This lesson contains nouns that has ha feminine gender.

Most feminine nouns ends in -a.

[Table]1
Nouns that ends in -a		Translation
la enfermera			nurse
la profesora			teacher
la doctora			doctor
la niña or la chica		girl
la hija				daughter
la pregunta			question

Nouns that have the following suffixes are usually feminine:

•Nouns that ends in -ción (usually equivalent of  English words that ends in -tion.
•Nouns that ends in -sión.
•Nouns that end in -ía (usually equivalent of English words that ends in -y).
•Nouns that ends in -za.
•Nouns that ends in -dad (similar to English words that ends in -ty).
•Nouns that ends in -itis (similar to English words that ends in -itis).

[Table]2
Nouns that ends in -ción	Translation
la nación			nation
la intervención			intervention
la hospitalización		hospitalization
la habitación			room
la canción			song
la posición			position


[Table]3
Nouns that ends in -sión	Translation
la ocasión			ocassion
la tensión			tension
la diversión			fun
la división			division

[Table]4
Nouns that end in -ía		Trnslation
la economía			economy
la taxonomía			taxonomy
la energía			energy
la alegría			joy
la melodía			melody

[Table]5
Nouns that ends in -za		Translation
la pobreza			poverty
la cabeza			head
la pieza			piece
la fuerza			force

[Table]6
Nouns that ends in -dad		Translation
la felicidad			happiness
la caridad			charity
la ciudad			city
la unidad			unit
la Universidad			university

[Table]7
Nouns that ends in -itis	Translation
la mastitis			mastitis
la meningitis			menigitis

Letters are feminine because "la letra" is feminine.

[Table]8
Letters
la A
la O
la B
la S
la L

Names of islands are usually feminine because "la isla" is feminine.

[Table]9
Islands				Translation
las Canarias			Canary Islands
las Azores			Azores
las Antillas			West Indies

Nouns that ends en -d and -z are usually feminine.

[Table]10
Nouns that ends in -d and -z	Translation
la virtud			virtue
la salud			health
la paz				peace
la nariz			nose
la luz				light
la voz				voice


Here are some of the exceptions:

[Table]11
Exception -a			Translation
el drama			drama
el enigma			enigma
el esquema			scheme
el estigma 			stigma

[Table]12
Exception -d			Translation
el huésped			guest
el ataúd			coffin
el abad				abbot
el alud				avalanche

[Table]13
Exception -z			Translation
el aprendiz			newbie
el cáliz			chalice
el arroz			rice
el pez				fish

[Table]14
Exception -ción and -sión	Translation
el ansión			ansion
el roción			spray
el notición			news
el sentención			sentence

Some nouns can have both gender depending on their form, adding -a on the word makes it feminine, these words are usually used to adress someone in their profession like the  following:

[Table]15
Words				Translation
el señor/ la señora		Mister/ Miss
el doctor/ la doctora		doctor
el profesor/ la profesora	professor


The gender of abbreviations and acronyms matches the gender of the main noun, and shortened word retains the gender of the longer word of the main noun.

[Table]16
Acronyms and shortened words	Reason
la NASA				the main noun in NASA is agency which 						translated to "agencia" which is feminine
el FBI				the main noun in FBI is Bureau which is 					translated as "buró" which is masculine
la moto				short form of "motocicleta"
la foto				short form of "fotografía"

If the noun is plural and refers to a group of people with mixed gender we will use the masculine form. E.g., los niños for group of boys or group of boys and girls while las niñas for group of girls.



































