Nouns are words that are used to indicate people, places, animals, things, ideas, and feelings.

Spanish nouns are gendered, either masculine or femenine, it is better to learn the noun with its article.

[Example]
Persona: Juan, la niña, el doctor
Lugar: el jardín, la universidad, España 
Cosa: el libro, el carro/coche, el tomate
Idea: la libertad, la tristeza, la lealtad


Most masculine nouns ends in -o.

[Table]1
Nouns that ends in -o		Translation
el niño	or el chico		boy
el libro			book
el cartero			mailman
el cuchillo			knife
el pello			hair
el teatro			theater

Some masculine nouns does not end woth -o, instead they are most likely to end with:

•Accented vowels(á, é, í, ó, ú).
•Consonant appart from -d and -z.
•Nouns that end in -ma, most of this words is of Greek(-pa, -ta) origin and have an English cognates.
•Nouns that end in -e.
[Table]2
Accented vowels			Translation
el papá				dad
el café				coffee
el ají				chili pepper
el bambú			bamboo
el rubí				ruby
el tabú				taboo

[Table]3
Consonant appart from -d and -z	Translation
el jardín			garden
el árbol			tree
el doctor			doctor
el señor			sir/mister
el cojín			cushion

[Table]4
Nouns that end in -ma		Translation
el problema			problem
el drama			drama
el programa			program
el idioma			language
el tema				subject
el poema			poem

[Table]5
Nouns that end in -e		Translation
el tomate			tomato
el estante			shelf
el perfume			perfume
el hombre			man
el nombre			name

Some masculine nouns can have other endings such as:

•Nouns that ends in -aje (usually the equivalent of -age in English).
•Nouns that ends in -ambre.
•Nouns that ends in -or.

[Table]6
Nouns that ends in -aje		Translation
el coraje			courage
el mensaje			message
el espionaje			espionage

[Table]7
Nouns that ends in -ambre
el alambre			wire
el hambre			hunger
el calambre			cramp

[Table]8
Nouns that ends in -or		Translation
el calor 			heat
el dolor			pain
el interior			interior

Infinitives that are used as nouns are usually masculine and singular.

[Table]9
Infinitive noun			Translation
el beber (to drink)		drinking
el caminar (to walk)		walking
el vivir (to live)		living
el fumar (to smoke)		smoking
el cantar (to sing)		singing
el viajar (to travel)		traveling

Months and Days of the week are masculine.

[Table]10
Days of the week		Translation
el lunes			Monday
el martes			Tuesday
el miércoles			Wednesday
el jueves			Thursday
el viernes			Friday
el sábado			Saturday
el domingo			Sunday

[Table]11
Months of the year		Translation
el enero			January
el febrero			February
el marzo			March
el abril			April
el mayo				May
el junio			June
el julio			July
el agosto			August
el septiembre			September
el octubre			October
el noviembre			November
el diciembre			December

Numbers is masculine "el número" is masculine.

[Table]12
Numbers				Translation
el doce				twelve
el quince			fifteen
el veinticico			twenty-five
el treinta y quatro		thirty-five
el sesenta			sixty
el setecientos			seven hundred

Compund nouns where verb is followed by a noun are masculine.

[Table]13
Compund nouns			Translation
el rascacielos			skyscrapper
el dragaminas			minesweeper
el guardarropa			clothes closet
el tragamondedas		slot machine/vending machine

Chemical element names are masculine.

[Table]14
Chemical element		Translation
el oxígeno			oxygen
el oro				gold
el cobre			copper
el hidrógeno			hydrogen
el chloro			chlorine
el neón				neon


Geographical names such as:

•Names of rivers because "el río" is masculine.
•Names of lakes because "el lago" is masculine.
•Names of oceans because "el océano" is masculine.

[Table]15
Bodies of water			Translation
el Pasifico			the Pacific
el Atlántico			the Atlantic
el Maracaibo			Maracaibo Lake
el Tigris			Tigris river
el Amazonas			the Amazon


•Names of mountains because "el monte" is masculine.
 
[Table]16
Mountains			Translation
los Apalache			the Appalachian
los Andes			the Andes
el Everest			the Everest

Borrowed foreign words are usually masculine unless there is a reason for it to be feminine.

[Table]17
Borrowed Words			Translation
el bistec			beefsteak
el champú			shampoo
el software			software
el show				show


Here are some of the exceptions:
18
Exception -or			Translation
la flor				flower
la coliflor			cauliflower
la sor				sister(religious)
la labor			work
19
Exception chemical elements	Translation
la plata			silver
20
Exception mountains		Translation
las Rocosas,			rocky
or las Montañas Rocosas		rocky mountain
21
Exception borrowed words	Translation
la pizza			pizza
la web				web or world wide web
22
Exception -o			Translation
la foto (fotografía)		photo (photography)
la mano				hand
la moto				motorcycle
la libido			libido
la radio			radio
la polio			polio
la virago			virago
23
Exception appart from -d and -z	Translation
la miel				honey
la sal				salt
la hiel				gall
la piel				skin
24
Exceptions -e			Translation
la llave			wrench
la calle			street
la fiebre			fever
la carne			meat
la nieve			snow
la noche			night
la suerte			lucky
la gente			people











